000000011000000
000000010000000
000000010000000
000010000000001
000010000000000
000000000000000
000000000010000
000000000011000
111100000001000
100000000001000
100000000000000
000000000000000
000000000000000
000011100000111
000000100000000
000000000000000
000000000000000
000000000011000
000000000011000
000000000011000
